################################################################
#                                                              #
#                                                              #
#       XXX       XXX                      XXX       XXX       #
#      X###X     X###X                    X###X     X###X      #
#      X###X     X###X                    X###X     X###X      #
#      X###       ###X                    X###       ###X      #
#       XX    X    XX                      XX    X    XX       #
#            X#X                                X#X            #
#       XX    X                                  X    XX       #
#      X###                                          ###X      #
#      X###X                                        X###X      #
#      X###X                                        X###X      #
#       XXX          X                   X           XXX       #
#                   X#XX               XX#X                    #
#                  X###XXX           XXX###X                   #
#                   X#XX               XX#X                    #
#                                                              #
#                                                              #
#                   X#XX               XX#X                    #
#                  X###XXX           XXX###X                   #
#                   X#XX               XX#X                    #
#       XXX          X                   X           XXX       #
#      X###X                                        X###X      #
#      X###X                                        X###X      #
#      X###                                          ###X      #
#       XX    X                                  X    XX       #
#            X#X                                X#X            #
#       XX    X    XX                      XX    X    XX       #
#      X###       ###X                    X###       ###X      #
#      X###X     X###X                    X###X     X###X      #
#      X###X     X###X                    X###X     X###X      #
#       XXX       XXX                      XXX       XXX       #
#                                                              #
#                                                              #
################################################################